#######.#########
#######.........#
#######.#######.#
#######.#######.#
#######.#######.#
#####  B    ###.#
...##  C    ###.#
##.##       ###.#
##...DE  F  ###.#
#####    G  ###.#
#########.#####.#
..#######...###.#
#.#########.###.#
..#########.....#
###########.#####